10 10
0 0
9 9
1010000000
1000010000
1111011111
0111000000
1111110111
0000100000
0010100000
0010100000
0010000000
0010000000