101 51
0 48
92 5
01000100000100010000000101000100000000000001000000010000000001000000000001000001000000000000000000010
01010101010101010111110101010101111101111101001101110111011101111101111101010101001111111111111111010
01010001010001000100010100010001000001000001000101000100010100000101010001010101000100000000000001010
01111111011111111111010111111111011111011111110101011100110111110101010111110101110101111111111101010
01000000010000000001010000000100010100010001000100010100010000010101000100000100010101000100000101000
01011111110111111101011111110101110101110101011111010111010111110101011101111111010101110100110101110
00010000010100000100000000010001000101000101010001000101010100010001010001000001010000000100010101000
11110101010100111111111111011111010101011101110101110101010101011111010111110101010011111111010101011
01000101000100010000010001010000010100010100000100010001010001000001000100010101010001000001010101010
01001101111101010011010101011101110111110111111111011101010111111101111101010101011101011101010101010
00000101000101010001000101010001000100000100000100010001010100010000010001000101010001010100010001010
11111101010101011101111101010011110111010111110100111111010100110111110101111111011111010111111111010
00000001010001000101000001010000010000010001000100000000010100010100010100000001000000010000010001000
00111111011111110101001111010011011111111101001111111111110111010101010111111101111111110011010101110
00010000010000010001000000010001010000010001000100000100000100010001000100010000000000010001010101000
11010111110111011111111111111101011101010011010101010100111101011111111101010111111111011101010111011
00010100000101000000000000000101010001010001010001010100000001010100010001000100010000010001000100010
01110111011101111111111111110111010011111101110011010111111111010101010111111111010111110111110101110
01010000010000000001000000010001010000000100010001010000010001010101000100000000010100000100010101000
01011111110111011101110011111101010011110111011111011111011101010101111100111101110100111111010101010
01010000010100010100010000010001010000010000010001010001000100000101000000000101000100000100010100010
01010100110101110111010111010011010111110011110101010101110111111101001111111101011101110101010111110
01000100000101010001010100010001010100010001000100010100010000000101000100000100010001000101010101000
01111101111101010101010101011101011101011101010111110111011111110101111100110100111111011101110101011
01000101000101000101010101000101010001010101010100010001000001000100010000010100000001010000010101010
01010101001101001101011101111101010111010101110101011101111101001101010111110111111101010011010101010
00010101000101000101000001000001000100010001000101010001000101000101000100010001000101010001000001010
00110101110101111101111101001111001101110011001111010011011101110101111101011101010101011111111111010
00010101000100000100000101000100000101000001000100010000010001000101000001000001010100010000000001010
11110101010111110111010101110111111101111101110100111101110101001101011101111111010111010111111101010
00010100010000010001010000010000000100010100010100000101000101000101010001000000010100010100000100010
01010111110111111101011111111111110111010111010101001101011101110101011111011111110111110111110111110
01000100010100000001000001000000010000010000010101000001010100010101010000010000010100010000000001000
01111101010101111111011111001111011111110011110101111111010101110111010011111111010101011111111101010
00010001010101000000010000000001000100010000000100010000010101000100010000000000010001000000000101010
11010101110101001111110111111111011101011111111111010011110101011100111111111111011111111111110101010
00010101000101000100010100000001010001000000000000010000010001010000000000000101010000010001000100010
00111101011101110101010100111101010111111111110011111111011111011111011111110101010111010101001111110
00000101010100010101000100000100010100010000010001000001010000010000010000010001000100010101000000010
11110101010111010101111111110111110111010011011101110111010111110011110011110111111100110101111111010
00000101010001010100010000000100000000010001000100010100010100010000010000000100010000000100000100010
00111101011101011111010101111101111111011101110111010101010100110111011111111101010111111111111101010
00010001000001000001010101000101010001010101010001000101010100000100010000000001000100000001000101010
01010101111101110011010111010101010101010101011101011101010100111101110011111111111101111101010101010
01010100000000010000010001010000010101000100010001010001010100000101000001000000000001000100010001010
01011111111111111100111101011111110101110111010011110011110111111101001111011111111101010101111111110
01000000010000000100010001010001000100010001010000010001000100010001000100010100000001010101000100010
01111111010111110111110011010101001111011111011111010101001101010101110101110100111111010111010101010
00000101000101000100010000000101000101000001010001010100000001000100010101000000000100010100010001000
11110101111101001101011111111111110101111101010101011111111111111111110101111111111100110100111111111
00000000000001000001000000000000000000000100000101000000000000000000000100000000000000010000000000000
